0;5.-2.x;1;434;48;0;1;-30000;-1;-1
1;;1;434;60;;0;2;-1;-1
2;;1;400;60;;1;3;-1;-1
3;;1;400;48;;2;-1;-1;-1
4;;1;396;120;;2;56;-1;-1
5;;1;466;184;;6;-30000;-1;-1
6;;1;454;184;;5;-1;-1;-1
7;5.-1.x;2;212;66;;8;22;-30000;-1
8;;2;208;102;;7;9;-1;-1
9;;2;208;118;;8;10;11;-1
10;;2;226;118;;9;-1;-1;-1
11;;2;206;128;;9;12;-1;-1
12;;2;170;128;;11;13;-1;-1
13;;2;142;128;;12;14;-1;-1
14;;2;118;128;;13;15;-1;-1
15;;2;102;128;;14;16;-1;-1
16;;2;82;128;;15;17;-1;-1
17;;2;52;128;;16;18;-1;-1
18;;2;26;128;;17;19;-1;-1
19;;2;26;80;;18;20;35;-1
20;;2;26;40;;19;21;-1;-1
21;;2;26;18;;20;-1;-1;-1
22;5.0.x;3;212;66;;23;7;40;-1
23;;3;212;88;;22;24;25;-1
24;;3;238;88;;23;-1;-1;-1
25;;3;212;118;;23;26;27;28
26;;3;242;118;;25;-1;-1;-1
27;;3;212;160;;25;-30000;-1;-1
28;;3;166;118;;25;29;-1;-1
29;;3;144;118;;28;30;-1;-1
30;;3;120;118;;29;31;-1;-1
31;;3;98;118;;30;32;-1;-1
32;;3;74;118;;31;33;-1;-1
33;;3;52;118;;32;34;-1;-1
34;;3;26;118;;33;35;-1;-1
35;;3;26;80;;34;36;19;69
36;;3;26;70;;35;37;38;39
37;;3;8;70;;36;-30000;-1;-1
38;;3;48;74;;36;-30000;-1;-1
39;;3;26;36;;36;-1;-1;-1
40;5.1.x;4;212;66;;41;22;71;-1
41;;4;212;114;;40;42;59;-1
42;;4;212;134;;41;43;59;58
43;;4;234;134;;42;44;-1;-1
44;;4;256;134;;43;45;-1;-1
45;;4;280;134;;44;46;-1;-1
46;;4;300;134;;45;47;-1;-1
47;;4;324;134;;46;48;-1;-1
48;;4;348;134;;47;49;-1;-1
49;;4;368;134;;48;50;-1;-1
50;;4;396;134;;49;51;55;-1
51;;4;414;134;;50;52;-1;-1
52;;4;444;134;;51;53;-1;-1
53;;4;444;112;;52;54;-1;-1
54;;4;414;112;;53;55;-1;-1
55;;4;396;82;;50;54;56;-1
56;;4;396;120;;55;57;4;83
57;;4;396;44;;56;-1;-1;-1
58;;4;212;160;;42;-30000;-1;-1
59;;4;186;120;;41;42;60;-1
60;;4;166;120;;59;61;-1;-1
61;;4;142;120;;60;62;-1;-1
62;;4;120;120;;61;63;-1;-1
63;;4;100;120;;62;64;-1;-1
64;;4;68;120;;63;65;-1;-1
65;;4;52;120;;64;66;-1;-1
66;;4;26;120;;65;67;68;-1
67;;4;4;120;;66;-1;-1;-1
68;;4;26;104;;66;69;-1;-1
69;;4;26;80;;68;70;35;93
70;;4;26;36;;69;-1;-1;-1
71;5.2.x;5;212;66;;72;40;95;-1
72;;5;212;130;;73;85;-1;-1
73;;5;230;130;;72;74;-1;-1
74;;5;256;130;;73;75;-1;-1
75;;5;276;130;;74;76;-1;-1
76;;5;296;130;;75;77;-1;-1
77;;5;310;130;;76;78;-1;-1
78;;5;330;130;;77;79;-1;-1
79;;5;348;130;;78;80;-1;-1
80;;5;364;130;;79;81;-1;-1
81;;5;396;130;;80;82;83;-1
82;;5;420;130;;81;-1;-1;-1
83;;5;396;82;;81;84;56;114
84;;5;396;58;;83;-1;-1;-1
85;;5;188;130;;72;86;-1;-1
86;;5;166;130;;85;87;-1;-1
87;;5;144;130;;86;88;-1;-1
88;;5;120;130;;87;89;-1;-1
89;;5;102;130;;88;90;-1;-1
90;;5;72;130;;89;91;-1;-1
91;;5;50;130;;90;92;-1;-1
92;;5;26;130;;91;93;-1;-1
93;;5;26;80;;92;94;69;125
94;;5;26;44;;93;-1;-1;-1
95;5.3.x;6;212;66;;96;71;127;-1
96;;6;212;112;;97;116;117;-1
97;;6;226;112;;96;98;99;-1
98;;6;232;120;;97;102;131;-1
99;;6;272;112;;97;100;101;-1
100;;6;292;112;;99;101;103;105
101;;6;288;122;;99;100;102;-1
102;;6;272;122;;101;98;131;-1
103;;6;300;120;;100;104;134;-1
104;;6;342;122;;107;103;134;-1
105;;6;342;112;;100;106;107;-1
106;;6;362;112;;105;107;108;109
107;;6;356;122;;104;105;106;-1
108;;6;368;120;;106;111;138;-1
109;;6;398;112;;106;110;114;-1
110;;6;410;112;;109;112;-1;-1
111;;6;410;122;;112;108;138;-1
112;;6;426;120;;110;111;113;-1
113;;6;436;122;;112;-1;-1;-1
114;;6;396;82;;109;115;83;140
115;;6;396;50;;114;-1;-1;-1
116;;6;182;112;;96;117;119;-1
117;;6;198;122;;96;116;118;-1
118;;6;182;122;;117;120;143;-1
119;;6;132;112;;116;120;121;-1
120;;6;140;120;;119;118;143;-1
121;;6;120;120;;119;122;-1;-1
122;;6;90;120;;121;123;-1;-1
123;;6;64;120;;122;124;-1;-1
124;;6;20;116;;123;125;148;-1
125;;6;26;80;;124;126;93;149
126;;6;26;50;;125;-1;-1;-1
127;5.3Z.x;7;212;66;;128;95;-1;-1
128;;7;212;112;;127;129;141;-1
129;;7;288;112;;128;130;132;-1
130;;7;288;122;;129;131;-1;-1
131;;7;272;122;;130;98;102;-1
132;;7;356;112;;129;133;135;-1
133;;7;356;122;;132;134;-1;-1
134;;7;342;122;;133;103;104;-1
135;;7;396;112;;132;136;140;-1
136;;7;422;112;;135;137;-1;-1
137;;7;426;122;;136;138;139;-1
138;;7;410;122;;137;108;111;-1
139;;7;436;124;;137;-1;-1;-1
140;;7;396;82;;135;114;-1;-1
141;;7;196;112;;128;142;144;-1
142;;7;196;122;;141;143;-1;-1
143;;7;182;122;;142;118;120;-1
144;;7;128;112;;141;145;-1;-1
145;;7;112;121;;144;146;-1;-1
146;;7;92;121;;145;147;-1;-1
147;;7;64;121;;146;148;-1;-1
148;;7;20;116;;147;149;124;-1
149;;7;26;80;;149;125;-1;-1
